#######
#     #
# ### #
# #   #
# # # #
#   # #
### #X#
# @   #
#######
